ICM20948	KEYWORD1
x	KEYWORD1
y	KEYWORD1
z	KEYWORD1
w	KEYWORD1

available	KEYWORD2
clearAvailable	KEYWORD2
begin	KEYWORD2
update	KEYWORD2

INV_SENSOR_TYPE_ACCELEROMETER	LITERAL1
INV_SENSOR_TYPE_GYROSCOPE	LITERAL1
INV_SENSOR_TYPE_RAW_ACCELEROMETER	LITERAL1
INV_SENSOR_TYPE_RAW_GYROSCOPE	LITERAL1
INV_SENSOR_TYPE_UNCAL_MAGNETOMETER	LITERAL1
INV_SENSOR_TYPE_UNCAL_GYROSCOPE	LITERAL1
INV_SENSOR_TYPE_BAC	LITERAL1
INV_SENSOR_TYPE_STEP_DETECTOR	LITERAL1
INV_SENSOR_TYPE_STEP_COUNTER	LITERAL1
INV_SENSOR_TYPE_GAME_ROTATION_VECTOR	LITERAL1
INV_SENSOR_TYPE_ROTATION_VECTOR	LITERAL1
INV_SENSOR_TYPE_GEOMAG_ROTATION_VECTOR	LITERAL1
INV_SENSOR_TYPE_MAGNETOMETER	LITERAL1
INV_SENSOR_TYPE_SMD	LITERAL1
INV_SENSOR_TYPE_PICK_UP_GESTURE	LITERAL1
INV_SENSOR_TYPE_TILT_DETECTOR	LITERAL1
INV_SENSOR_TYPE_GRAVITY	LITERAL1
INV_SENSOR_TYPE_LINEAR_ACCELERATION	LITERAL1
INV_SENSOR_TYPE_ORIENTATION	LITERAL1
INV_SENSOR_TYPE_B2S	LITERAL1

ICM_SUCCESS	LITERAL1
ICM_BAD_WHOAMI	LITERAL1
ICM_MAG_ERROR	LITERAL1
ICM_SERIAL_ERROR	LITERAL1
ICM_SETUP_ERROR	LITERAL1
ICM_DMP_ERROR	LITERAL1